4555555555555554
6111111111111116
6111000000001116
6111111010111116
6111000010011116
6111011010111116
6120000013111116
6111111111111116
4555555555555554