455555555555554
611111111111116
611011101131116
610001000001316
611100010101016
612110111000016
610000011101016
611111111111116
455555555555554